000000000000000000000000000000000000000000000000000000000000
011111111111111111111111111111111111111111111111111111111110
011111111111111111111111111111111111111111111111111111111110
011000000000000000002200000000000000000000000000000000000110
011000000000000000002200000000000000000000000000000000000110
011000000000000000002200000000000000000000000000000000000110
011000000000000000002200000000000000000000000400000000000110
011000000000000000002200000000000000000000000000000000000110
011000000000000000002200000000000000000000000000000000000110
011000000000000000002200000000000000000000000000000000000110
011000000000000000001100000000000011222222000000000000000110
011000000000000000001100000000000011222222000000000000000110
011000000000000000001100000000000000000022000000000000000110
011000000000000000001100000000000000000022000000000000000110
011000000000000000001100000000000000050022000000000000000110
011000000000000000001100000000000000000022000000000000000110
011000000000000000001100000000000000000011000000000000000110
011000000000000000001100000000000000000011000000000000000110
011000000000000000111100000000000000000011000000000000000110
011000000000000000111100000000000000000011000000000000000110
011000000000000000110000000000000000000011000000000000000110
011000000000000000110000000000000000000011000000000000000110
011000000000000000110000000000000000000011000000000000000110
011000000000000000110000000000600000000011000000000000000110
011000000000000000110000000000000000000011000000000000000110
011000000000000000110000000000000000000011000000000000000110
011000000000000000110000000000000000001111000000000000000110
011000000000000000110000000000000000001111000000000000000110
011000000000000000110000000000000000001100000000000000000110
011000000000000000110000000000000000001100000000000000000110
011000000000000000220000000000000000001100000000000000000110
011000000000000000220050000000000000001100000000000000000110
011000000000000000220000000000000000001100000000000000000110
011000000000000000220000000000000000001100000000000000000110
011000000000000000222222110000000000001100000000000000000110
011000000000000000222222110000000000001100000000000000000110
011000000000000000000000000000000000002200000000000000000110
011000000000000000000000000000000000002200000000000000000110
011000000000000000000000000000000000002200000000000000000110
011000000000004000000000000000000000002200000000000000000110
011000000000000000000000000000000000002200000000000000000110
011000000000000000000000000000000000002200000000000000000110
011000000000000000000000000000000000002200000000000000000110
011111111111111111111111111111111111111111111111111111111110
011111111111111111111111111111111111111111111111111111111110
000000000000000000000000000000000000000000000000000000000000
